R  13 255
SO south.c
NO north.cub
WE west.cub
EA east.cub
S  sprite.cub
F 253, 14,255
C 200,10,222

111111111111111
100000000000001
100000000000001
100000000000001
100000000000001
1N000000000001
111111111111111         