R  13 255
SO south.c
NO north.cub
WE west.cub
EA east.cub
S  sprite.cub
F 253, 14,255
C 200,10,222

1111                 
    1S001                     
10101            
10001       
10001
10001
10001          
10001
10001  
10001
12121      
11 1