R  13 255
SO south.c
NO north.cub
WE west.cub
EA east.cub
S  sprite.cub
F 253,254,255
C 200,10,222


11111  1111  1  
1S001111001111
10000000000001
10000200000001
10000000000021
10100110110111
 1 11  1  1