R  1000 600
SO south.c
NO north.cub
WE west.cub
EA east.cub
S  sprite.cub
F 253, 14,255
C 200,10,222

11111
1111
1S11
11111